000000000000000000000000000000000000000000000000000000000000000000
000000000000000200000000000000000000000000000000000000000000000000
000000000000000100000000000000000000000000000000000000000000000000
000000000000000100000000000000000000000000000000000000000000000000
000000002000000100000000000000000000000000000000000000000000000000
000000001000000100000000000000000000000000000000000000000000000000
000000001000000100000000000000000000000000000000000000000000000000
222222222222222222222222222222222222222222222222222222222222222222
000000000000000000000000000000000000000000000000000000000000000000
000000000000000000000000000000000000000000000000000000000000000000
000000000000000000000000000000000000000000000000000000000000000000
000000000000000000000000000000000000000000000000000000000000000000
000000000000000000000000000000000000000000000000000000000000000000